- Spotify 使用ランキング上位30ヵ国 と その国の共通言語 -
アメリカ - en, en_US
ブラジル - pt, pt_BR
ドイツ - de
メキシコ - es
イギリス - en, en_GB
イタリア - it
スペイン - es
フランス - fr
カナダ - en, fr
オーストラリア - en
フィリピン - fil, en
オランダ - nl
インドネシア - id
アルゼンチン - es
チリ - es
トルコ - tr
スウェーデン - sv
インド - hi, en
ポーランド - pl
ノルウェー - nb, (no)
ペルー - es, (quz, ay)
デンマーク - da
日本 - ja
コロンビア -es
フィンランド - fi, sv
マレーシア - ms
シンガポール - ms, en, zh
アイルランド - ga, en
ベルギー - fr, de, nl
ニュージーランド - mi, en

- 結果書かなきゃいけない言語 (アルファベット順) -
da - デンマーク語   //
de - ドイツ語   //
en - 英語   //
es - スペイン語   //
fi - フィンランド語   //
fil - フィリピノ語   \\ Google翻訳にない！！ //
fr - フランス語   //
ga - アイルランド語   //
hi - ヒンディー語   //
id - インドネシア語   //
it - イタリア語   //
ja - 日本語   //
mi - マオリ語   //
ms - マレー語   //
nb - ノルウェー語   //
nl - オランダ語   //
pl - ポーランド語   //
pt - ポルトガル語   //
sv - スウェーデン語   //
tr - トルコ語   //
zh - 中国語   //

参考資料
https://djk2.hatenablog.com/entry/2019/07/31/021131
